name Very Small Labyrinth of Dooom
win 1
#####################
#.................#
#......G..........#
#.................#
#..E..............#
#..........G......#
#.................#
#.................#
###################